œ=oe

(s)=
/=

est-il=étil
 est = ai 
 es = ai 
n'est=nai
n'=n
N'=n

c'est=sè
s'est=sè

parent=paran
fille=fi
yaourt= ya ourte
film=filme
bille=bi
tempête =tempête, 
oeil=euil
chevelure=cheveulure
jusque=jusqueu
violent=violan
sac=saque
parce que=parceu que
faisant=feusan
puzzle=peuzelle
menu=meunu
bouche=bou che
puis=pu is
plus =pluse 
choeur=coeur
soeur=seure
presse-papier=presse papier
